success	sucesso
campus workers	obreiros	Parece se referir à equipe de uma organização missionária, como o pessoal do escritório.
seep down	penetrar	Verificar.
full-time ministry workers	ministros de tempo integral
Numbers	Números
ministry assignment	atribuição ministerial	No começo do livro, usei apenas "ir para o campo missionário".
instill	inculcar
launch out	começar, iniciar
support raising	levantar sustento
funds	recursos
pursue	buscar diligentemente
donor	doador
early on	no começo	(bem) no começo
figure	valor, importância
policy	política
State Director	Diretor Estadual
Dallas Theological Seminary	Seminário Teológico de Dallas
Promised Land	Terra Prometida
income	renda
sharp	inteligente, astuto, esperto
best-case scenario	situação ideal
core value	valor fundamental
furnish	suprir, fornecer
funding plan	plano de financiamento
take stock	fazer um levantamento
grief-stricken	agoniado, aflito, enlutado	Dic. Michaelis
passionate	fervoroso
burdened	aflito
Lord	Senhor
NEEMIAH	NEEMIAS
launch into	começar
God Ask	Deus Pede	fazer um pedido a Deus
Levites	levitas
God	Deus
smooth talk	lábia
at every turn	em cada etapa
most	a maior parte de
Nebuchadnezzer	Nabocodonozor
venture capital	capital de risco
assignment	atribuição, tarefa
tarnish	manchar
ventures	empreendimentos
board	comida	servida em hotel
push back	resistência
office building	prédio comercial
verse	versículo
verses	versículos
apostle	apóstolo
Paul	Paulo
Old Testament	Antigo Testamento
New Testament	Novo Testamento
compensation	remuneração
longstanding	antigo
support trainer	professor de captação de recursos
Jesus Christ	Jesus Cristo
furnish	mobiliar
craft	construir
pursuit	busca	atividade
well over	bem mais
