science	ciência
repeatable reproduzível
speciation especiação
reliable eyewitness testimony testemunho ocular confiável
assumption pressuposto
starting assumptions pressupostos iniciais
molecules to man evolution evolução de moléculas a humanos
truth claims reivindicações da verdade
faulty logic lógica falha
universe	universo
creation	criação
falsifiable	falsificável
testable	analisável
predictable	previsível
uniformitarianism	uniformitarismo
uniformitarians	uniformitaristas
–	–
interpretation	interpretação
decay	decomposição
uranium	urânio
helium	hélio
fossils	fósseis
evolutionary	evolutivo
coelacanth	celacanto
fossil	fóssil
bias	inclinações
random chance	acaso
interpretations	interpretações
history	história
wisdom	sabedoria
knowledge	conhecimento
counteract	neutralizar
natural selection	seleção natural
kind	espécie
dating methods	métodos de datação
agnosticism	agnosticismo
atheism	ateísmo
evolution	evolução
follow-up	complementar
inconsistency	inconsistência
Christian	cristão
nature	natureza
uniformity	uniformidade
theistic	teísta
brain	cérebro
Scholarly analysis	análise acadêmica
inconsistent	inconsistente
inevitable	inevitável
chemistry	química
physics	física
necessarily	necessariamente
evolution	evolução
technology	tecnologia
outer planets	planetas externos
respectively	respectivamente
Astronomy	Astronomia
Mathematics	Matemática
Physiologist	Fisiologista
impossible	impossível
Radiohalos	Rádio-halos
influence	influência
astronomer	astrônomo
insupportable	infundado
organ	órgão
billions	bilhões
